11111111111
1C0PCCC00C1
10000C00001
1000E000001
100C0000001
11111111111