1111111
1C01C11
10PC001
100C001
10EC001
1111111