11111111111111111111111111111111
1001C000000000000000000000000001
1C000000000000000000000000000001
1C0CPC00000000000000000000000001
11E10C00000000000000000000000001
11111111111111111111111111111111