111111111111
100100000001
1000C0P00001
110001111001
11E100000001
111111111111