111111111
1C0P000P1
100000001
1000E0001
100000001
100000001
111111111