111111111111
1C1100100001
1000C1P00011
100001111001
11E100000001
111111111111
111011011101