111111111
1C0P00001
100000001
1000E0001
100000001
100000001
111111111