11111111111111
1C0PCCC00CC001
10000C00000001
1000E000000001
100C0000000001
10000C00000001
10000C00000001
10000C00000001
10000C00000001
10000C00000001
10000C00000001
11111111111111