1111111
1001C11
1C00001
1C0CPC1
11E10C1
1111111