11111111111111111111111111111111
10000C000000110000C0000001111111
10000000000011000000000001111111
10011000000011001100000001111111
100110000C001100110000C001111111
10000000000000000000000001000001
10000000000000000000000000000001
100C000111001100C000111001000001
1C000000110C11C000000110C1000001
1C000000110C11C001110110C1000001
10000C000000110001C0000001000001
10000000000011000111000001000001
10011000000011001100000001000001
100110000C001100110000C001000001
10000000000011000000000001000001
10000000000011000000000001000P01
100C000111001100C000111001000001
10000000000000000000000000000001
10000C000000110000C0000001111111
10000000000011000000000001111111
10011000000011001100000001111111
100110000C001100110000C001111111
10000000000000000000000001000001
10000000000000000000000000000001
100C000111001100C000111001000001
1C000000110C11C000000110C1000001
1C000000110C11C001110110C1000001
10000C000000110001C0000001000001
100000000000110001110E0001000001
10011000000011001100000001000001
11111111111111111111111111111111